0111111111111111111111111
1000P00000000000000000001
1011000111111111010000C01
1010000000000011011111111
10111111000000100100000E1
1000000000000010110000001
1111111111110000001111101
1000000000000000001000001
1111111100000000001001001
1000000000000000001001001
1001000000000000001111001
1100000000000000000000001
0111111111111100011111110