111111111111111111
1000000000000000P1
1E0000000010000001
100000000011111111
100000000010000001
100000000010000001
100000000010000001
100000000010000001
10000000001000C001
100000000000000001
111111111111111111