111111111111111111
1P0000000000000001
100000000010000C01
100000000011111111
1111111000100000E1
100000000010000001
100000000011111101
100000000000000001
100000000000000001
111111111111111111