111111111111111111
100000000000000001
1E0000000010000001
111111111111111111
100000000010000001
10000P000010000001
100000000010000001
100000000010000001
10000000001000C001
100000000000000001
111111111111111111