111111111111111111
1000000000000000P1
100000000010000001
10E000000011111111
100000000010000001
100000000010000001
100000000010000001
100000000010000001
10000000001000C001
100000000010000001
111111111111111111