1111111111
1000000001
10P0000001
1111111011
1C01000001
1001011111
1000000001
1011111111
10000000E1
1111111111